111111111111111111111111
100000000030000003000001
100000000000000000000001
111100200000001111150001
100111100020021007000001
100000111111111001000001
100000003000300001011111
100000000000000001010301
102001200020002001000001
103001111111111111211101
120000010000000001117101
130000210000100000300101
100020310010150000000101
100030011004100010001101
100000010000150030000101
100200010104100000100101
100300015000150020000101
100000010004100030001101
111000110210150000000101
171000160104100000100101
101000111111110000000101
101500100000100010000101
100000000200000012222121
111111111111111111111111