111111111111111111111111
100000000000013000000071
100002000002010011100011
111111111111030000100411
141503000001000100100001
103000001501000001110001
100000023001020001010011
100015410011111111415001
100000037001000000000001
115000001003020000000011
130000001000010020001211
100415071121111110102341
111030011111333415323451
100020020000000010031061
110030037000000030003001
100200241004511000000011
111300300000001114111411
102002450000000000000031
103003000020020020000001
115004524511111111511001
100000030000010000001011
100000000000030200003001
100220002702000100100021
111111111111111111111111