111111111111111111111111
103000300000000000010701
100000002001111000030101
100020001201331000000101
111111111111001001000101
100000003000001221121101
100020000010001111111501
100010020010200000071001
100411111111111100011001
100210000000000100001001
100110041100000115001041
100411000111510100001001
120041500100000100011001
110004100100020100021001
115004101100111110031501
170000001300131100001001
111111111700003102000001
150030001111100111111111
100000261033110000000311
100111111570411000000041
100011033000031154151001
110000000410000000000011
150022000000002000000111
111111111111111122111111