111111111111111111111111
100000000030033003000001
100000000000000000000101
111100200000000111150041
100111100020022107000001
100003111111111101011111
100000030003000001010301
100000000000000001015041
100201200200020021000001
100301111111111111211101
102000010000000001117101
103002010004100000100101
120003010010150000300101
130020011004100010001101
100030010000150030000101
102000014104100000000101
103000010000150002041101
100020010014100203000101
111030110200150300000101
171000160104100000001101
101000111111110000000101
101504130003150010000101
100000000200000012222121
111111111111111111111111