111111111111111111111111
100000070000074150000001
117000000000011100410011
111000000020000000010111
111100000010000222011111
111111011111111111111111
111111000000000004111111
111111100000220041111111
111111110000000000000111
111111111111111111110111
111111111111111111100111
111001111111111111170111
100001111111111111110111
100111111111111111110111
104130001000010010000004
100000203000000000000004
115020100000010000222164
111111111111111111111111
111111111111111111111111
111111111111111111111111
111111111111111111111111
111111111111111111111111
111111111111111111111111
111111111111111111111111