111111111111111111111111
100000000000015000000071
100000222002015011100011
111111111111030003104501
141500300001000100100001
103000001501020001110011
100000023001212021000001
100415415011111111454501
100030037031000003000001
115000001003020000000211
130020001200012020012311
100415071121111110003041
111030011111333412220451
100020020003000413334561
110030037000020030045041
100200241045211000000011
111300300000333154100411
102002450000000000311531
103003000045002020000001
112024524511111111011001
103030030000310004501011
100000000000030200003001
102222202022007120100021
111111111111111111111111