111111111111111111111111
103003300000000030010701
100000002001111000010101
100222001221331500030101
111111111111001001000101
100000003000001221121101
100020000010201111111501
100012002212100000071001
150411111111111150411041
100215000000000100031001
104110041100200112001501
100411203111110103001001
120041100100300100011041
115004100150002100201001
111504101100111110311501
170000001304131100010001
111111111700003102000221
150003001111120111111111
100200261033110000003311
104111111570411200200041
100311133020031122151001
110000000410000133100011
150022220000020000002111
111111111111111122111111