111111111111111111111111
131300000000000000000001
103000000000000000000001
100000000000000000000001
100000000020000000700001
162000000011111111111001
111100000000000000000001
100000000000000000000001
100000000000000000000001
100000000000000000000011
100000000000000000000111
100000000000000000001111
100000000000000000011111
122200000000000000111111
111111111111111111111111
100000000000000000000001
100000000000000000000001
100000000000000000000001
100000000000000000000001
100000000000000000000001
100000000000000000000001
100000000000000000000001
100000000000000000000001
111111111111111111111111