111111111111111111111111
100000301010033003003301
100200003010000000000001
111100200000022111545041
100111150020211100000001
100007111111111101011111
100000030003033001010301
100000000200000001015741
100001220122020221000001
100021111111111111211101
100030010000000001113101
100202010004100000100101
100303010010150000300101
120000011004100015001101
130200010200150030000101
102320010104100000200101
103030015000150000341101
100000015024100200003101
111002110010150300000101
131503160204170000415101
100020111311115020030101
101134130003150012000101
100000000200000211222121
111121121122111111111111