111111111111111111111111
100000000000015000000001
100000222002015011100001
111111111111030003104501
141500300001000100120001
103000001501020001110411
100020023001212221000001
100415415011131111524501
100030037031000303030001
115000001503020000000271
130020041200012020012311
100415001121111110003041
111030011111333412220451
100020027003000413334561
110030030000020030045041
100200241045211500000011
111300300000333154102211
102002450200000000311331
103003000345002022000001
112024524511111111011501
103030030033310004501001
100000000000030200003011
102222202202007120100021
111111111111111111111111