111111111131111111111111
103003300000000030410701
100000002021111000010101
100222201211331501030101
111111111111001001000101
100000003000001221221101
100020000010201113111501
100012022212100000071041
150411111111111150411001
100215000000000100001501
104110041100200112041001
150411203111110103001041
120041100133300150001001
115004101100002100201041
111504101304111110311501
170000001000131100010001
111111111720003102000221
150333031111120111111111
100000201703110003003311
104111161500411200200041
100011145000031122151001
145000000020000133100011
100022220410220000002211
111111111111111222111111