111111111111111111111111
131300000000000000000001
103000000000000000000001
100000000000000000000001
102000000022220000700001
161000000011111111111001
111100000000000000000001
100000000000000000000001
100000000000000000000001
100000000000000000000211
100000000000000000000111
100000000000000000001111
100000000000000000011111
122220000000000000111111
111111111111111111111111
100000000000000000000001
100000000000000000000001
100000000000000000000001
100000000000000000000001
100000000000000000000001
100000000000000000000001
100000000000000000000001
100000000000000000000001
111111111111111111111111