111111111111111111111111
100000041000610000000001
100000041000010001541501
100000041200410001000001
100000001110000011415041
100000000000000001000001
100000000000000001041541
100000000000000001000001
101000000000000001415001
101000000000000001000001
101000000000000001041501
101000000000000001200001
101111111111111111111101
100000000000010000000001
111101110111111111011111
100101000000000010000001
100101111111011012201011
100101000000001011111011
100101011111111013000021
100101000000001010011011
100001111111101000010001
101111500000001001010101
100041500000001221210201
111111111111111111111111