111111111111111111111111
100000000000000000000001
110000000000000000000011
111000000000000000000111
111100000000000000001111
111110000000000000011111
111111000000000000111111
111111100000000001111111
111111110000000011111111
111111111000000111111111
111111111111111111111111
111111111111111111111111
111111111111111111111111
111111111111111111111111
111111111111111111111111
111111111111111111111111
111111111111111111111111
111111111111111111111111
111111111111111111111111
111111111111111111111111
111111111111111111111111
111111111111111111111111
111111111111111111111111
111111111111111111111111